00000000000000000000
00000000000000000000
00000000000000000000
00000000000000000000
00000000000000000000
00000000000000000000
00000011111110000000
00000014434410000000
00000014414410000000
00000012333210000000
00000012232210000000
00000012333210000000
00000012225210000000
00000011111110000000
00000000000000000000
00000000000000000000
00000000000000000000
00000000000000000000
00000000000000000000
00000000000000000000