00000000000000000000
00000000000000000000
00000000000000000000
00000000000000000000
00000000000000000000
00000001111000000000
00000011221000000000
00000015321100000000
00000011322100000000
00000011223100000000
00000014322100000000
00000014494100000000
00000011111100000000
00000000000000000000
00000000000000000000
00000000000000000000
00000000000000000000
00000000000000000000
00000000000000000000
00000000000000000000